NO ./textures/wall_ironfold.xpm
SO ./textures/wall_moria.xpm
WE ./textures/wall_mithrin.xpm
EA ./textures/wall_gundabad.xpm

F 200,180,160
C 100,150,200

11111111111111111111111111111111
10000000001000000000100000000001
10000000001000000000100000000001
10000000001000000000100000000001
10000000000000000000000000000001
10000000001000000000100000000001
10000000001000000000100000000001
11111011111000000000111110111111
10000000001000000000100000000001
10000000001000000000100000000001
10000000000000E00000000000000001
10000000001000000000100000000001
10000000001000000000100000000001
11111011111000000000111110111111
10000000001000000000100000000001
10000000001000000000100000000001
10000000000000000000000000000001
10000000001000000000100000000001
10000000001000000000100000000001
10000000001000000000100000000001
11111111111111111111111111111111
