NO ./textures/wall_ironfold.xpm
SO ./textures/wall_moria.xpm
WE ./textures/wall_mithrin.xpm
EA ./textures/wall_gundabad.xpm
DO ./textures/wall_ironfold.xpm

F 135,135,135
C 70,130,180

111111111
100000001
10N000001

100010001
111111111
