NO ./textures/wall_ironfold.xpm
SO ./textures/wall_moria.xpm
WE ./textures/wall_mithrin.xpm
EA ./textures/wall_gundabad.xpm

F 100,80,60
C 40,40,60

1111111111111111111111111
1000000000100000000000001
1000000000100000000000001
1000000000100000000000001
1000000000100000000000001
1000000000100000001111111
100001000010000000N001
10000D000000000000000011
100001000000000000000001
111100000011111000000001
100000000000001000000001
100000000000001000000001
100000000000001000000001
100000000000001000000001
1111111111111111111111111
