NO ./textures/wall_ironfold.xpm
SO ./textures/wall_moria.xpm
WE ./textures/wall_mithrin.xpm
EA ./textures/wall_gundabad.xpm

F 50,50,50
C 20,20,80

111111111111111111111
100000000000000000001
100000000000000000001
100000111110000000001
100000100010000000001
100000100010000000001
1000001000D0000000001
100000111110000000001
100000000000000000001
100000000000N00000001
100000000000000000001
100000000000000000001
111111111111111111111
