NO ./textures/wall_ironfold.xpm
SO ./textures/wall_moria.xpm
WE ./textures/wall_mithrin.xpm
EA ./textures/wall_gundabad.xpm

F 50,50,50
C 20,20,80


1111111111111111111111111
1000000000100000000100001
1000000000D00000000D00001
1000000000100000000100001
1000000011111011111111111
1444444410000000200000001
3000000040000000202222221
1404444410000000000000001
1000000010000000000000001
10N00000100000000111D1111
1000322210000000010000001
1000D00020000000010000001
1000300020000000010000001
1111122221111111111111111
