NO ./textures/wall_ironfold.xpm
NO ./textures/wall_moria.xpm
SO ./textures/wall_moria.xpm
WE ./textures/wall_mithrin.xpm
EA ./textures/wall_gundabad.xpm

F 135,135,135
C 70,130,180

11111
10N01
11111
