NO ./textures/north.xpm
SO ./textures/south.xpm
WE ./textures/west.xpm
EA ./textures/east.xpm

F 100,80,60
C 40,40,60

1111111111111111111111111
1000000000100000000000001
1000000000100000000000001
1000000000100000000000001
1000000000100000000000001
1000000000100000001111111
100000000010000000N001
100000000000000000000001
100000000000000000000001
111100000011111000000001
100000000000001000000001
100000000000001000000001
100000000000001000000001
100000000000001000000001
1111111111111111111111111
